"","hero","city","evil","puzzle","enemy","licensed_content_video_games","mission","destroy_devastate_wreck","rescue","epic","story","magic","team_group_crew_squad","weapon","mystery","dangerous","level_stage"
"929198",1,1,1,0,0,0,0,0,0,0,0,0,0,0,0,0,0
"944706",0,0,0,1,1,1,1,1,1,0,0,0,0,0,0,0,0
"945121",0,0,0,0,0,0,0,0,0,1,1,0,0,0,0,0,0
"951867",0,0,0,0,0,0,0,0,0,0,0,1,0,0,0,0,0
"954263",0,1,0,0,0,1,0,0,0,0,1,0,1,1,0,0,0
"959196",0,1,0,0,1,0,0,0,0,0,0,0,0,0,1,0,0
"959942",0,0,0,0,0,0,0,0,0,0,0,1,0,0,0,1,0
"961274",0,0,0,0,0,0,0,0,0,0,0,0,0,0,0,0,1
