"","fight","destroy_devastate_wreck","battle","defend","discover_reveal","solve","combat","mission","explore","race","defeat","strategy_tactics","attack"
"929914",1,0,0,0,0,0,0,0,0,0,0,0,0
"938954",1,1,0,0,0,0,0,0,0,0,0,0,0
"942025",0,0,1,1,1,0,0,0,0,0,0,0,0
"942350",0,0,0,0,1,1,0,0,0,0,0,0,0
"943672",0,1,0,0,0,0,1,0,0,0,0,0,0
"944568",0,0,0,0,1,1,0,1,1,1,0,0,0
"948959",1,1,0,1,0,0,0,1,0,0,1,1,1
"956856",1,1,0,0,0,0,0,0,0,0,0,0,0
