"","battle","dangerous","army","mission","war","weapon","city","explore","rescue","defeat","hero","enemy"
"932882",1,1,1,1,1,1,0,0,0,0,0,0
"933037",0,0,0,0,0,0,1,0,0,0,0,0
"939458",0,0,0,0,0,0,1,1,0,0,0,0
"942198",0,0,0,0,0,0,0,0,1,1,0,0
"950874",0,0,0,0,1,0,0,1,1,0,1,1
