"","realistic_accurate","mystery","fast","enemy","tournament_competition","compete","evil","dangerous","city","race","action"
"604291",1,0,0,0,0,0,0,0,0,0,0
"605586",0,1,0,0,0,0,0,0,0,0,0
"605593",0,0,1,1,1,0,0,0,0,0,0
"605961",1,0,0,0,0,1,0,0,0,0,0
"614995",0,0,0,0,0,0,1,1,0,0,0
"620598",0,0,0,0,1,0,0,0,0,0,0
"621031",0,0,1,1,0,0,0,1,0,0,0
"628160",0,0,0,1,0,0,0,0,1,0,0
"630985",0,0,0,0,1,0,0,0,0,0,0
"638789",0,0,1,1,0,0,0,0,0,1,0
"971360",0,0,1,0,0,0,0,0,0,0,0
"998009",0,0,0,0,0,0,0,0,1,0,1
