"","horde_wave_mass","destroy_devastate_wreck","evil","team_group_crew_squad","attack","army","war","battle","the_earth","hero","enemy","magic","adventure","action","fast","mission","epic","story","weapon"
"929259",1,1,1,1,1,1,0,0,0,0,0,0,0,0,0,0,0,0,0
"930013",0,0,0,0,0,0,1,1,1,0,0,0,0,0,0,0,0,0,0
"932515",0,1,1,0,0,0,0,1,0,1,1,1,1,0,0,0,0,0,0
"941684",0,0,0,0,0,0,0,0,0,0,0,0,0,1,1,0,0,0,0
"941958",0,0,0,0,0,1,1,0,0,0,1,0,0,0,0,1,0,0,0
"942139",0,0,0,0,0,0,0,0,0,0,0,0,0,1,0,0,0,0,0
"942165",0,0,1,1,0,0,1,0,0,1,0,0,0,1,0,0,1,1,0
"943088",0,0,0,0,0,0,0,0,0,0,0,0,0,0,0,0,0,0,1
