"","destroy_devastate_wreck","war","army","human_race_mankind","weapon","city","enemy","hero","story","the_earth","tournament_competition","puzzle"
"952954",1,1,1,1,0,0,0,0,0,0,0,0
"959363",0,1,0,0,1,1,1,0,0,0,0,0
"960103",0,0,0,0,1,0,0,1,1,0,0,0
"971353",1,0,1,0,0,0,1,0,0,0,0,0
"985981",0,1,0,0,0,0,1,0,0,1,0,0
"995075",0,0,0,0,0,0,0,0,0,0,1,0
"997982",0,0,1,0,1,0,1,0,0,0,0,1
