"","enemy","fast","realistic_accurate","tournament_competition","race","level_stage","team_group_crew_squad","compete","destroy_devastate_wreck"
"944952",1,1,0,0,0,0,0,0,0
"948030",0,0,1,0,0,0,0,0,0
"950870",0,0,1,1,0,0,0,0,0
"955086",0,1,1,1,0,0,0,0,0
"957702",0,0,1,0,0,0,0,0,0
"957703",0,0,1,0,0,0,0,0,0
"960122",0,0,0,0,1,0,0,0,0
"960538",0,0,0,0,0,1,0,0,0
"961030",0,0,1,1,0,0,1,0,0
"970793",0,0,0,0,0,0,0,1,0
"972982",0,0,0,0,0,0,0,0,1
