"","level_stage","mystery","adventure","puzzle","enemy","magic"
"604138",1,0,0,0,0,0
"971669",1,1,1,0,0,0
"972801",1,0,0,0,0,0
"978737",1,0,0,1,0,0
"979375",1,0,0,0,0,0
"984907",1,0,0,1,0,0
"990143",1,0,0,0,1,0
"991432",1,0,0,1,0,0
"997197",1,0,0,1,0,1
