"","army","level_stage","licensed_content_video_games","weapon","realistic_accurate","mystery","war","action","magic","evil","attack","story","enemy","licensed_content_cultural_products","epic","hero"
"928518",1,1,1,0,0,0,0,0,0,0,0,0,0,0,0,0
"939067",0,0,1,0,0,0,0,0,0,0,0,0,0,0,0,0
"940048",0,0,0,1,1,1,1,0,0,0,0,0,0,0,0,0
"943402",0,0,0,0,0,0,0,1,1,1,1,0,0,0,0,0
"943566",0,0,1,0,0,0,0,0,0,0,0,1,1,1,0,0
"944315",0,0,0,0,1,0,0,0,0,0,0,0,0,0,0,0
"945861",0,0,0,0,0,0,0,0,0,0,0,0,1,0,0,0
"946570",0,0,0,0,0,0,0,0,0,0,0,1,0,0,0,0
"950179",0,0,1,0,0,0,0,0,0,1,0,0,0,0,1,1
