"","realistic_accurate","team_group_crew_squad","tournament_competition","enemy","compete","shoot"
"928311",1,1,0,0,0,0
"930953",0,0,1,0,0,0
"932164",1,1,1,0,0,0
"932196",1,0,0,1,0,0
"932867",0,0,1,0,0,0
"932932",0,1,0,0,0,0
"933142",0,1,0,1,0,0
"933693",1,1,1,1,1,0
"933709",1,0,0,0,0,0
"935088",1,0,0,0,0,0
"935290",0,1,0,0,0,1
