"","the_earth","war","epic","story","puzzle","city","enemy","mystery","weapon","fast","dangerous","realistic_accurate","action","licensed_content_video_games"
"942006",1,1,1,0,0,0,0,0,0,0,0,0,0,0
"942955",0,0,0,1,0,0,0,0,0,0,0,0,0,0
"943397",0,0,0,1,1,1,1,1,1,0,0,0,0,0
"943500",0,0,0,0,0,0,1,0,1,1,0,0,0,0
"950186",0,0,0,1,0,1,0,0,0,0,1,1,0,0
"957923",0,0,1,0,0,0,0,0,0,0,0,0,0,0
"960509",0,0,0,0,0,0,0,0,0,0,0,0,1,0
"996092",0,1,1,0,0,1,1,0,0,0,0,0,0,1
