"","puzzle","story","city","enemy","evil","level_stage","army","horde_wave_mass","epic"
"605744",1,1,0,0,0,0,0,0,0
"614182",1,1,0,0,0,0,0,0,0
"623147",0,0,1,0,0,0,0,0,0
"630993",0,1,0,1,1,1,1,0,0
"991127",0,0,0,1,0,0,0,1,0
"997845",0,0,1,1,1,0,0,0,1
