"","war","evil","hero","enemy","action","weapon","story","city","puzzle","epic","army","human_race_mankind","licensed_content_cultural_products","licensed_content_video_games","team_group_crew_squad"
"929914",1,1,1,0,0,0,0,0,0,0,0,0,0,0,0
"938954",0,0,1,1,1,1,1,0,0,0,0,0,0,0,0
"942025",0,1,1,0,0,0,0,1,1,0,0,0,0,0,0
"942350",0,0,0,0,0,0,0,0,1,0,0,0,0,0,0
"943672",1,0,0,1,0,1,0,0,0,1,1,1,1,0,0
"944568",0,0,0,0,0,0,0,1,1,0,0,0,0,1,0
"948959",1,0,0,1,1,1,0,1,0,0,0,0,1,0,1
"956856",0,0,0,1,0,0,0,0,0,1,0,0,0,1,0
