"","army","enemy","team_group_crew_squad","fast","puzzle","story","war","attack","weapon","licensed_content_cultural_products","level_stage","licensed_content_video_games","horde_wave_mass","evil","city","destroy_devastate_wreck","shoot"
"606553",1,1,1,1,0,0,0,0,0,0,0,0,0,0,0,0,0
"945591",1,0,0,0,1,1,1,0,0,0,0,0,0,0,0,0,0
"974106",1,0,0,0,0,0,0,1,0,0,0,0,0,0,0,0,0
"974852",0,0,0,1,0,0,0,0,1,1,0,0,0,0,0,0,0
"986214",0,1,0,1,0,0,0,0,0,0,1,0,0,0,0,0,0
"996046",0,0,0,0,0,0,1,0,0,0,0,1,0,0,0,0,0
"996586",1,0,0,0,0,0,0,0,1,0,0,0,1,0,0,0,0
"997573",0,0,0,0,0,0,0,0,0,0,0,0,0,1,1,0,0
"998609",0,0,0,0,0,0,0,1,0,0,0,0,0,0,0,1,1
