"","city","horde_wave_mass","evil","hero","weapon","war","army","human_race_mankind","enemy","magic","puzzle","story","level_stage","battle","fast","the_earth","dangerous"
"672891",1,0,0,0,0,0,0,0,0,0,0,0,0,0,0,0,0
"682468",0,1,1,1,1,1,0,0,0,0,0,0,0,0,0,0,0
"706032",0,0,0,0,1,1,1,1,1,0,0,0,0,0,0,0,0
"707565",0,0,0,0,0,0,0,0,0,1,1,1,0,0,0,0,0
"710243",0,0,0,0,0,0,0,0,1,0,0,0,1,0,0,0,0
"717507",0,0,0,0,1,0,0,0,1,0,0,0,0,1,1,0,0
"760435",0,0,0,0,0,0,0,1,0,0,0,0,0,0,0,1,0
"784751",0,0,0,0,0,0,0,0,1,1,0,0,0,0,0,0,1
