"","tournament_competition","team_group_crew_squad","realistic_accurate","enemy","level_stage","defend"
"612081",1,1,0,0,0,0
"616326",1,0,1,0,0,0
"624639",1,1,1,0,0,0
"625123",1,1,1,1,0,0
"626255",0,1,0,0,0,0
"627288",1,1,0,0,0,0
"627462",0,1,0,0,0,0
"630380",1,1,0,0,0,0
"630498",0,0,1,0,0,0
"632493",0,0,1,0,0,0
"997359",1,0,0,1,1,1
