"","solve","explore","adventure","rescue","fight","battle","shoot"
"618770",1,1,1,0,0,0,0
"640253",0,0,0,1,0,0,0
"954855",0,0,0,0,1,0,0
"974869",0,0,0,0,0,1,1
"989945",0,0,0,1,0,0,0
