"","realistic_accurate","fast","team_group_crew_squad","tournament_competition","licensed_content_video_games","action","story"
"605252",1,1,0,0,0,0,0
"605747",1,0,0,0,0,0,0
"609390",1,1,1,0,0,0,0
"618273",0,0,0,1,0,0,0
"627574",0,0,0,0,1,0,0
"632402",1,0,0,0,0,0,0
"996445",1,0,0,0,0,0,0
"997443",0,0,0,0,0,1,0
"997600",1,1,0,0,0,0,1
