"","story","city","shoot","enemy","action","war","weapon","horde_wave_mass","human_race_mankind","mystery","army","destroy_devastate_wreck","hero","the_earth","rescue","evil","puzzle"
"605579",1,1,0,0,0,0,0,0,0,0,0,0,0,0,0,0,0
"605604",1,0,1,1,1,1,0,0,0,0,0,0,0,0,0,0,0
"625218",0,1,0,0,0,0,1,1,0,0,0,0,0,0,0,0,0
"640660",0,1,0,1,0,0,0,0,1,1,1,0,0,0,0,0,0
"950940",0,1,0,0,0,0,0,0,1,0,0,1,0,0,0,0,0
"997926",0,0,0,0,0,0,0,0,0,0,0,1,1,1,1,1,0
"997931",1,1,0,1,0,0,0,0,0,0,0,0,0,0,0,1,1
