"","puzzle","solve","dangerous","explore","mystery","adventure","epic","story","hero","mission","enemy","weapon","fight","army","horde_wave_mass","city","rescue","battle","shoot","licensed_content_cultural_products","human_race_mankind"
"618770",1,1,1,1,1,1,1,1,0,0,0,0,0,0,0,0,0,0,0,0,0
"626631",0,0,0,1,0,0,0,1,1,1,1,1,1,0,0,0,0,0,0,0,0
"628357",0,0,1,0,0,0,0,0,0,0,0,0,0,1,0,0,0,0,0,0,0
"640253",0,0,0,0,0,0,0,0,0,0,1,0,0,0,1,1,1,0,0,0,0
"954855",0,0,0,0,0,0,0,0,0,0,0,0,1,0,0,1,0,0,0,0,0
"974869",0,0,0,0,0,0,0,1,0,0,0,0,0,0,0,0,0,1,1,0,0
"981375",0,0,0,0,0,0,0,1,0,0,0,0,0,0,0,1,0,0,0,1,0
"989945",0,0,0,0,0,0,0,0,1,0,1,0,0,0,0,1,1,0,0,0,1
