"","action","licensed_content_video_games","level_stage","enemy","fast","puzzle","realistic_accurate"
"930069",1,1,0,0,0,0,0
"952299",1,0,0,0,0,0,0
"954473",0,0,1,1,0,0,0
"954862",1,0,1,1,1,1,0
"955441",0,0,0,0,0,1,0
"955479",0,0,1,0,0,0,0
"957669",1,0,1,0,0,1,0
"958943",0,0,0,0,0,1,0
"960170",0,0,0,0,0,1,0
"971686",0,0,1,0,0,1,0
"973240",0,0,1,0,0,0,0
"978341",0,0,0,0,1,0,1
