"","city","mystery","story","dangerous","hero","the_earth","enemy","human_race_mankind","magic","weapon","war","epic","action","army","evil"
"616012",1,1,1,1,1,1,0,0,0,0,0,0,0,0,0
"620591",0,1,0,0,0,0,1,1,1,0,0,0,0,0,0
"674413",0,0,1,0,0,0,1,0,0,1,0,0,0,0,0
"680021",0,0,0,0,0,0,1,0,0,0,1,0,0,0,0
"684236",0,1,0,0,0,0,0,0,0,1,0,0,0,0,0
"693067",0,1,1,0,0,0,0,0,1,0,1,1,1,0,0
"718652",0,0,0,0,1,0,0,0,0,0,0,0,0,1,1
