"","story","epic","mystery","enemy","the_earth","war","evil","team_group_crew_squad","hero","army","human_race_mankind","battle","puzzle","destroy_devastate_wreck","adventure","magic"
"928334",1,1,1,0,0,0,0,0,0,0,0,0,0,0,0,0
"932979",0,0,0,1,0,0,0,0,0,0,0,0,0,0,0,0
"935661",0,0,0,0,1,1,1,1,1,0,0,0,0,0,0,0
"938642",0,0,1,0,0,0,0,0,0,0,0,0,0,0,0,0
"939444",0,0,1,1,1,1,0,0,0,1,1,1,0,0,0,0
"942210",0,0,0,0,1,0,0,0,1,0,0,0,1,1,0,0
"943325",0,0,0,1,0,0,0,0,0,0,0,0,0,0,1,1
