"","tournament_competition","realistic_accurate","enemy","fast","weapon","licensed_content_video_games","story","dangerous"
"928289",1,1,0,0,0,0,0,0
"929261",0,0,1,0,0,0,0,0
"930863",0,0,1,0,0,0,0,0
"932239",0,0,0,1,0,0,0,0
"932465",1,1,1,0,1,1,1,0
"932715",0,1,0,0,0,0,0,0
"932938",1,0,1,0,0,0,0,0
"932993",1,0,0,0,0,0,0,0
"933860",0,1,0,0,0,0,0,0
"933868",0,1,0,0,1,0,0,1
"936838",1,0,0,0,0,0,0,0
