"","army","story","hero","human_race_mankind","mystery","attack","licensed_content_cultural_products","dangerous","adventure","battle","war","horde_wave_mass","weapon","licensed_content_video_games","level_stage","city","defeat","the_earth","puzzle","magic","epic"
"928391",1,1,1,1,0,0,0,0,0,0,0,0,0,0,0,0,0,0,0,0,0
"934472",0,0,1,0,1,1,1,1,1,0,0,0,0,0,0,0,0,0,0,0,0
"937017",0,0,0,0,0,0,0,0,0,1,1,1,0,0,0,0,0,0,0,0,0
"937212",1,0,0,0,0,0,0,0,0,0,1,0,0,0,0,0,0,0,0,0,0
"937424",1,0,1,0,0,0,0,0,0,0,1,0,1,0,0,0,0,0,0,0,0
"938006",0,0,0,0,0,0,0,0,0,0,0,0,0,1,1,1,0,0,0,0,0
"939310",1,0,1,0,0,0,0,0,0,0,0,0,0,0,0,0,1,0,0,0,0
"939346",0,0,1,0,0,0,1,0,0,1,0,0,0,0,0,0,0,1,1,0,0
"941527",0,0,0,0,0,0,0,0,0,0,0,0,1,0,0,0,0,0,0,1,1
