"","licensed_content_cultural_products","weapon","licensed_content_video_games","shoot","tournament_competition","attack","enemy","fast","battle","story","destroy_devastate_wreck","move_special_move","level_stage","realistic_accurate","team_group_crew_squad","action"
"611212",1,0,0,0,0,0,0,0,0,0,0,0,0,0,0,0
"620506",0,1,0,0,0,0,0,0,0,0,0,0,0,0,0,0
"626633",0,0,1,0,0,0,0,0,0,0,0,0,0,0,0,0
"627044",0,0,0,1,1,1,1,0,0,0,0,0,0,0,0,0
"630325",0,0,0,0,0,0,1,1,1,1,1,0,0,0,0,0
"632923",0,0,0,0,0,0,0,1,0,0,0,1,1,0,0,0
"635803",0,0,0,1,0,1,0,0,1,0,0,0,0,1,0,0
"637240",1,0,1,0,0,0,0,0,0,0,0,0,0,0,0,0
"646483",0,0,0,0,0,0,1,0,0,0,0,0,1,0,0,0
"961032",0,0,0,0,0,0,0,1,0,0,0,0,0,0,0,0
"995375",1,0,1,0,0,0,0,0,0,0,0,0,0,0,1,0
"999446",0,0,0,0,0,0,0,1,1,0,0,0,0,0,0,1
