"","army","licensed_content_video_games","realistic_accurate","story","war","the_earth","epic","attack","human_race_mankind","weapon","action","hero","horde_wave_mass","enemy","mission","city"
"939208",1,1,1,1,1,0,0,0,0,0,0,0,0,0,0,0
"939445",0,0,0,0,1,1,1,1,0,0,0,0,0,0,0,0
"942201",0,0,0,0,1,0,0,0,1,1,0,0,0,0,0,0
"942883",1,0,0,0,0,1,0,0,0,0,1,1,1,0,0,0
"943966",1,1,0,0,1,0,0,0,1,0,0,0,0,1,0,0
"944932",1,0,0,0,1,0,0,0,0,1,0,0,0,0,1,0
"945393",0,0,0,0,1,0,0,0,0,0,0,0,0,0,0,0
"946301",0,0,0,0,0,0,0,1,0,1,0,0,1,1,0,0
"950885",0,0,0,0,0,0,0,0,0,0,0,1,0,0,0,1
