"","destroy_devastate_wreck","puzzle","enemy","mystery","licensed_content_video_games","evil","hero","action","weapon","level_stage","dangerous","the_earth","human_race_mankind","fast","story","city","magic","war","army","horde_wave_mass","team_group_crew_squad"
"604077",1,1,1,0,0,0,0,0,0,0,0,0,0,0,0,0,0,0,0,0,0
"605254",0,0,0,1,1,1,1,1,0,0,0,0,0,0,0,0,0,0,0,0,0
"612072",0,0,1,0,0,0,1,0,1,1,0,0,0,0,0,0,0,0,0,0,0
"614978",0,0,0,0,1,0,0,0,0,1,0,0,0,0,0,0,0,0,0,0,0
"620509",0,1,0,0,0,0,1,0,0,1,0,0,0,0,0,0,0,0,0,0,0
"620823",0,0,0,0,0,0,0,0,0,0,1,0,0,0,0,0,0,0,0,0,0
"621209",0,0,0,0,0,0,0,0,0,0,0,1,1,0,0,0,0,0,0,0,0
"625926",0,0,1,0,0,0,0,0,0,1,0,0,0,0,0,0,0,0,0,0,0
"627224",0,0,0,0,1,0,0,0,0,0,0,0,0,0,0,0,0,0,0,0,0
"627416",0,0,1,0,0,1,0,1,0,1,0,0,0,1,0,0,0,0,0,0,0
"627553",0,0,0,0,1,0,0,0,0,0,0,1,0,0,0,0,0,0,0,0,0
"632665",1,0,0,0,0,0,0,0,0,0,0,0,0,0,1,0,0,0,0,0,0
"634005",0,0,0,1,0,0,0,0,0,0,0,0,0,0,1,1,0,0,0,0,0
"634060",0,1,1,1,0,0,1,1,0,0,0,0,0,0,0,0,1,0,0,0,0
"634344",1,0,0,0,0,0,0,0,0,0,0,0,0,0,0,0,0,0,0,0,0
"637269",0,1,0,1,0,0,0,0,0,1,0,0,0,0,0,0,0,0,0,0,0
"639758",0,0,0,0,0,1,0,0,0,0,0,1,0,0,0,0,0,0,0,0,0
"640857",0,0,0,0,1,0,0,0,0,1,0,0,0,1,1,0,0,0,0,0,0
"641694",0,1,1,1,1,1,0,0,1,0,0,0,0,0,0,0,0,1,0,0,0
"954843",0,0,0,0,1,0,0,0,0,1,0,0,0,0,1,0,0,0,0,0,0
"971438",0,1,0,0,0,0,0,0,0,0,0,0,0,0,0,0,0,0,0,0,0
"995070",0,0,0,0,0,0,0,0,1,0,0,0,0,0,0,0,0,1,1,0,0
"997372",0,0,0,0,0,0,0,1,0,0,0,1,0,0,0,0,0,0,0,1,0
"997471",1,0,0,0,0,0,0,1,0,0,0,0,0,0,0,0,0,0,0,0,0
"998090",0,1,0,0,0,0,1,0,0,0,1,0,0,0,0,0,1,0,0,0,0
"998304",0,0,1,1,1,0,1,0,0,1,0,0,0,0,0,0,0,0,0,0,1
