"","solve","explore","journey","adventure","mission","combo","photograph_picture","fight","find","rescue","kill","battle","shoot","confront"
"618770",1,1,1,1,0,0,0,0,0,0,0,0,0,0
"626631",0,1,0,0,1,1,1,1,0,0,0,0,0,0
"628357",0,0,1,0,0,0,0,0,1,0,0,0,0,0
"640253",0,0,0,0,0,0,0,0,1,1,1,0,0,0
"954855",0,0,0,0,0,0,0,1,0,0,0,0,0,0
"974869",0,0,0,0,0,0,0,0,0,0,0,1,1,0
"989945",0,0,1,0,0,0,0,0,0,1,0,0,0,1
