"","weapon","enemy","city","mystery","story","epic","human_race_mankind","action","horde_wave_mass","online","evil","hero","licensed_content_video_games","puzzle"
"605976",1,1,0,0,0,0,0,0,0,0,0,0,0,0
"928006",0,0,1,1,1,0,0,0,0,0,0,0,0,0
"939413",0,0,0,0,1,1,1,0,0,0,0,0,0,0
"961275",1,1,0,0,1,1,0,1,1,0,0,0,0,0
"961285",0,0,0,1,0,0,0,0,0,1,1,0,0,0
"989132",0,0,1,0,0,0,0,0,0,0,0,1,0,0
"995071",0,0,0,0,0,0,0,0,0,0,0,0,1,1
