"","level_stage","story","destroy_devastate_wreck","puzzle","licensed_content_cultural_products","horde_wave_mass","dangerous","evil","weapon","enemy","mystery","war","the_earth"
"935585",1,0,0,0,0,0,0,0,0,0,0,0,0
"942122",0,1,1,1,1,1,0,0,0,0,0,0,0
"942723",0,0,0,0,0,0,1,0,0,0,0,0,0
"943006",0,0,0,1,0,0,0,1,1,1,1,1,0
"945612",0,1,0,0,0,0,0,0,0,0,1,0,0
"946376",0,0,0,1,0,0,0,0,0,0,1,0,0
"949115",0,0,0,0,1,0,0,0,0,1,0,0,1
"952841",1,0,0,1,1,0,0,0,0,0,0,0,0
"955027",0,0,0,0,0,0,0,0,0,1,0,0,0
