"","puzzle","dangerous","mystery","epic","story","army","licensed_content_video_games","horde_wave_mass","enemy","city","licensed_content_cultural_products","hero","human_race_mankind"
"618770",1,1,1,1,1,0,0,0,0,0,0,0,0
"628357",0,1,0,0,0,1,1,0,0,0,0,0,0
"640253",0,0,0,0,0,0,0,1,1,1,1,0,0
"954855",0,0,0,0,0,0,1,0,0,1,0,0,0
"960633",0,0,0,0,0,0,1,0,0,0,0,0,0
"974869",0,0,0,0,1,0,0,0,0,0,0,0,0
"981375",0,0,0,0,1,0,0,0,0,1,1,0,0
"989945",0,0,0,0,0,0,0,0,1,1,0,1,1
