"","destroy_devastate_wreck","city","race","team_group_crew_squad","licensed_content_video_games","story","tournament_competition","action","enemy","fast","epic"
"958272",1,1,0,0,0,0,0,0,0,0,0
"959893",0,0,1,1,0,0,0,0,0,0,0
"960422",0,1,0,0,1,0,0,0,0,0,0
"960619",0,0,0,0,0,1,0,0,0,0,0
"971450",0,1,0,0,0,0,0,0,0,0,0
"979301",0,0,0,0,0,0,1,0,0,0,0
"984916",0,0,0,0,0,0,0,1,1,1,0
"991782",0,1,1,0,0,0,0,0,0,0,0
"997709",0,0,1,0,0,0,0,0,0,0,1
"997715",0,0,0,0,1,0,0,1,1,0,0
