"","mystery","magic","team_group_crew_squad","hero","epic","the_earth","evil","licensed_content_video_games","enemy","story","weapon","fast","puzzle","dangerous","level_stage","battle"
"680070",1,1,0,0,0,0,0,0,0,0,0,0,0,0,0,0
"702770",1,0,1,1,1,1,1,0,0,0,0,0,0,0,0,0
"703417",0,0,0,0,0,0,0,1,1,0,0,0,0,0,0,0
"706838",0,1,0,0,0,0,0,0,0,1,0,0,0,0,0,0
"722615",0,0,0,0,0,0,0,1,0,1,1,0,0,0,0,0
"722909",0,0,0,0,0,0,0,0,1,0,0,1,1,1,1,0
"958900",1,0,0,0,0,0,1,0,0,1,0,0,0,0,1,1
