"","army","war","enemy","level_stage","team_group_crew_squad","battle","shoot","hero","horde_wave_mass","weapon","destroy_devastate_wreck","story","mystery","rescue","action"
"945597",1,1,0,0,0,0,0,0,0,0,0,0,0,0,0
"958985",1,0,1,0,0,0,0,0,0,0,0,0,0,0,0
"959041",1,0,1,1,1,0,0,0,0,0,0,0,0,0,0
"959288",0,0,1,0,0,1,1,1,1,1,1,0,0,0,0
"960638",1,1,0,0,0,0,0,0,0,0,0,1,1,0,0
"961038",0,0,1,0,1,0,0,0,0,0,0,0,0,1,0
"974789",1,0,0,0,0,1,0,0,0,0,0,0,0,0,1
