"","enemy","level_stage","licensed_content_cultural_products","epic","city","fast","realistic_accurate","hero","story","horde_wave_mass","weapon","the_earth"
"605791",1,0,0,0,0,0,0,0,0,0,0,0
"960530",1,1,0,0,0,0,0,0,0,0,0,0
"961233",0,0,1,0,0,0,0,0,0,0,0,0
"984778",1,1,0,1,1,1,0,0,0,0,0,0
"991148",0,0,0,0,0,0,1,1,0,0,0,0
"991402",0,0,0,0,0,0,0,0,1,0,0,0
"991483",0,1,0,0,0,0,0,0,0,0,0,0
"991497",0,1,0,0,0,0,0,0,0,0,0,0
"995912",0,0,1,0,0,0,0,0,0,0,0,0
"997664",0,0,0,0,0,0,0,0,0,1,1,1
