"","level_stage","puzzle","mystery","enemy","dangerous","team_group_crew_squad"
"611171",1,1,1,0,0,0
"622441",0,1,0,0,0,0
"624642",1,0,1,1,0,0
"632666",0,1,0,0,0,0
"632843",1,1,0,0,1,0
"991326",1,1,0,1,0,1
