"","action","evil","enemy","army","attack","dangerous","mission","fast","war","story","human_race_mankind","licensed_content_video_games"
"666759",1,0,0,0,0,0,0,0,0,0,0,0
"710975",0,1,1,1,1,1,0,0,0,0,0,0
"724307",0,0,1,0,0,1,1,1,0,0,0,0
"730869",0,0,0,0,0,0,0,0,1,1,1,0
"734622",0,0,0,0,0,1,0,0,0,0,0,0
"766676",0,0,1,0,0,0,0,0,0,0,1,0
"789217",0,0,0,1,0,0,0,0,0,1,0,1
"889956",0,0,1,0,0,0,0,0,0,0,0,0
