"","enemy","fast","level_stage","story","magic","mystery","evil"
"950907",1,1,1,0,0,0,0
"955083",0,0,0,1,0,0,0
"960104",1,0,0,0,0,0,0
"960215",1,0,0,0,0,0,0
"960594",1,0,0,0,1,1,0
"975367",0,0,0,0,1,1,1
