"","story","enemy","mystery","licensed_content_video_games","magic","the_earth","evil","combat","rescue","licensed_content_cultural_products","puzzle","hero","dangerous","destroy_devastate_wreck","epic","army","fast","city"
"939336",1,1,0,0,0,0,0,0,0,0,0,0,0,0,0,0,0,0
"952493",0,0,1,1,1,1,1,1,1,0,0,0,0,0,0,0,0,0
"960494",0,0,0,0,1,0,0,0,0,1,0,0,0,0,0,0,0,0
"960554",0,0,0,1,0,0,0,0,0,0,1,1,0,0,0,0,0,0
"975240",0,0,0,0,0,0,0,0,0,0,0,0,1,0,0,0,0,0
"980491",0,0,0,0,0,0,0,0,0,0,0,0,0,1,1,1,0,0
"991065",0,0,0,1,0,0,0,0,0,0,1,0,0,0,0,0,1,0
"997056",0,0,1,0,0,0,0,0,0,1,1,0,0,0,0,0,0,1
