"","action","human_race_mankind","licensed_content_video_games","story","enemy","puzzle","move_special_move","weapon","mystery","epic","level_stage","dangerous"
"605601",1,1,0,0,0,0,0,0,0,0,0,0
"615699",0,0,1,1,0,0,0,0,0,0,0,0
"667703",0,1,0,0,1,1,0,0,0,0,0,0
"670379",0,0,0,1,1,1,1,0,0,0,0,0
"672893",0,1,0,1,1,0,0,1,0,0,0,0
"680069",0,0,0,1,0,0,0,0,1,0,0,0
"684836",0,0,0,0,1,1,0,0,0,1,0,0
"704458",0,0,0,1,0,0,0,1,0,0,1,0
"720002",1,0,0,0,0,0,0,0,0,0,0,1
