"","rescue","enemy","mystery","magic","hero","war","weapon","the_earth","story","puzzle","human_race_mankind","army","city","mission"
"681989",1,1,0,0,0,0,0,0,0,0,0,0,0,0
"709407",0,0,1,1,1,0,0,0,0,0,0,0,0,0
"714747",0,0,0,1,0,1,1,0,0,0,0,0,0,0
"732890",0,0,0,0,0,1,0,1,1,1,1,0,0,0
"763235",0,0,0,0,0,1,0,0,0,0,0,1,1,0
"778830",0,0,0,0,0,1,0,0,1,0,0,0,0,1
