"","tournament_competition","city","realistic_accurate","destroy_devastate_wreck","enemy","action","fast","epic","race","dangerous"
"939160",1,1,0,0,0,0,0,0,0,0
"939534",0,0,1,0,0,0,0,0,0,0
"942026",0,0,1,0,0,0,0,0,0,0
"942792",0,0,1,1,0,0,0,0,0,0
"943020",0,0,1,0,1,0,0,0,0,0
"943354",0,0,0,0,0,1,0,0,0,0
"944519",0,0,0,1,0,0,1,0,0,0
"945382",1,0,1,0,0,0,0,0,0,0
"945406",0,0,1,0,0,0,0,1,0,0
"945664",1,0,0,0,0,0,0,0,1,0
"946588",0,0,0,0,0,1,0,0,0,1
"948965",0,1,1,1,1,1,1,0,0,1
