"","dangerous","level_stage","weapon","enemy","action","evil","mystery","magic"
"942016",1,1,0,0,0,0,0,0
"945804",0,1,0,0,0,0,0,0
"946431",0,0,1,0,0,0,0,0
"946472",0,0,0,1,1,0,0,0
"953912",0,0,0,0,0,1,1,1
